0 10 11 12 13 0 0 0 0 0
- 9 0 0 14 - - 0 39 99
0 8 0 0 15 0 - 0 38 0
0 7 0 0 16 0 0 0 37 0
0 6 0 0 17 0 34 35 36 0
0 5 0 0 18 0 33 0 0 0
0 4 0 0 20 0 32 31 30 0
0 3 0 0 21 0 0 0 29 0
0 2 0 0 22 0 0 0 28 0
0 1 - - 23 24 25 26 27 0