0 0 0 0 0 0 0 0 0 0
0 0 0 0 0 0 0 0 16 99
0 0 0 0 0 0 0 0 15 0
0 0 0 0 0 0 0 0 14 -
0 0 0 0 0 0 0 0 13 0
0 0 0 0 0 0 0 0 12 0
0 0 0 0 0 0 0 0 11 -
0 0 0 0 0 0 - - 10 0
0 2 3 4 5 6 7 8 9 0
0 1 0 0 0 0 0 0 - 0