0 0 0 0 0 0 0 0 0 0 
0 0 0 0 0 0 0 15 16 99
- - 0 0 0 0 0 14 0 0
0 - 0 0 0 11 12 13 0 0
0 0 0 0 0 10 - - 0 0
0 0 0 7 8 9 - - 0 0
0 0 0 6 0 0 0 0 0 0
0 3 4 5 0 0 0 - - 0
0 2 0 0 0 0 0 - - 0
0 1 0 0 0 0 0 0 0 0